OK	o q k e:
OK	o: k e:
みかん	m i k a N
りんご	r i N g o
ぶどう	b u d o u
いちご	i ch i g o
ごりら	g o r i r a
ラッパ	r a q p a
パセリ	p a s e r i
ご飯	g o h a N
コマンド	k o m a N d o
マウス	m a u s u
紅茶	k o u ch a
sony	s o n i:
キーボード	k i: b o: d o
DELL	d e r u
辞書	j i sh o
スヌーズ3分	s u n u: z u s a N p u N
スヌーズ5分	s u n u: z u g o f u N
あと3分	a t o s a N p u N
あと5分	a t o g o f u N
